12:12
230004000332
044003040000
030044440330
334440300300
343003334400
433033330044
000433344300
033433440330
000443003334
044000440033
000000403343
q40400440041