15:15
o2ooooooo+++++2
lM000dfsS000000
0000ddddddd0000
000000000000000
004444444444000
000000004m40000
00d000000400000
000000000000000
000000000000000
000000000000000
000000000000000
0mmmmmmmmmm0000
000000000000000
000000q00000000
000000100000000
