15:15
203333333333302
043434343434340
3333m3333333333
343434343434343
3333333m3333m33
343434343434343
333333333333333
343434343434343
3333m333333m333
343434343434343
333333333333333
343404040404343
333000000000333
343444040404343
33341q000003333