15:15
203304033433302
043030034303330
303440330300303
330333444033300
004344000443430
333340000004330
0004004q4004034
040400414004030
mm0400343004300
404340000043343
33430340430m343
304303300300040
03430344303m000
033300000434300
303043300033304