12:12
030003000330
044443444440
043303003340
340443344340
343403334340
343430034m43
04m403304340
343403304343
330440004333
343414004043
0434q4004340
204400004402