14:14
20300433033302
04433300043440
33004004444004
33444034030000
33330043000000
3430033300004q
43300333000041
34003334430034
00003334430034
03343344000004
30033400303004
34400044003300
00300040334303
33440044004333