15:15
203304000333302
034003040034330
330044440330303
034440300300304
043003334400333
0330333300mm003
000433344300304
333433440300334
004430000004340
344300000000034
00040004q400003
04030004140b000
43330003430000r
000330000040000
3r0300003300033
