12:12:0:2:1:2:0:0:0
0c0004000eD0
04400k040000
02D044440kk0
kc4440D00300
k4c00kaD4400
4ik0iacc0044
00043eD44k00
0ai4c3440kg0
00044j00kij4
0440004400ki
00000040ei4k
040400440041
